

 #####
 #   ####
 #      #
### **# #
#  #* *@#
#   * ###
#  ##  #
##     #
 #.$#  #
 #  ####
 ####